1111111111111
1001000000001
1000010000001
10PCE10000001
111111111111