1111111111111
1001000000001
0000010000001
1PCE010000001
1111111111111