1111111110111
1001000000001
1000010000001
1PCE010000001
1111111111111