1111111111111
1001000000001
10000100000011
1PCE010000001
1111111111111