1111111111111
1001000000001
1000010000000
1PCE010000001
1111111111111